Ahri – Electronic, Dance, Psytrance - @ahriluvu

Almost – Indie, Rock, Alternative - @almostiscool

Amateur Act – Pop Punk, Alt Rock - @amateur_act_official

Artisan P – Hip-Hop

BabyyDre – Hip-Hop (Freestyle) - @OfficialBabyyDre

Backwards Driving – Alt, Indie, Southeast Emo - @backwardsdriving

Band of Names – 70s Hard Rock, Punk, Psychedelic Soul Fusion - @bandofnames

Blair Stone – Punk, Rock - @blairstone_band

Brass Wizard – Metal, Experimental, Doom Jazz - @brasswizardfl

Bruvvy – Alt Rock, Emo - @bruvvyband

Callie Flemming & The Fifth Wave – No-Fi Rock, Punk, Indie Noise - @cfat5w

Callisto's Collapse – Prog Metal, Heavy Metal - @callistos_collapse

Caro Garcia – Solo Artist, Alt, Rock, Metal, Bass Guitarists - @caroo.garcia7

Castover – Indie, Alt - @castoverband

CJ and The Deadmen – Rock, Alt - @cjandthedeadmen

Cloud Storage – Shoegaze, Dream Pop, Indie Rock - @cloudstorageband

Counterfeit Stereo – Alt Rock, Indie Rock - @counterfeitstereo

Curly Q – Emo, Pop, Punk - @curlyqtheband

Dal3di – Electronic, Techno - @dal3di

Dallas Aleea – R&B - @dallasaleea

Dalton Lain – Techno, Electronic - @dalton.lain

Danitza – Alt Pop, Latin Pop, Indie Soul - @danitzaofficial

Dear Cincinnati – Midwest Emo - @dearcincinnati

Def Dogs – Hip-Hop Fusion - @defdogs

Dog Gone Planet – Folk Punk, Acoustic Emo - @doggoneplanet

Durty Suns – Rock, Indie Rock, Grunge - @durtysuns

Electric Angel – Funk, Soul - @electricangelband

Failed State – Heavy Metal, Metalcore, Thrash Metal - @failedstate. nflhc

Falls Chase – Hard Rock, Alt Rock-@falls_chase

FGT – Rap/Hip-Hop-@flyyguy.ty

Flying Bison – Jazz, Latin Music, Latin Funk-flyingbisonfl

Gabbalish – Electronic, Dance, House- @gabbalish.wav

Gangs Of Paris – Rock, Punk- @gangsofparis_band

Gila – Metal, Power Metal, Rock -@gila.fl

Housing Cows – Indie Rock, Alternative, Punk Rock - @housingcows

Internet Girlfriend – Punk, Rock - @internetgffl(remove, discontinued)

JaggN – Alt Metal, Emo-@jaggntheband

January Again – Indie, Folk, Alt- @january.again.music

Joybomb – Alt Punk, Rock 'n' Roll - @joybombofficial

Kanise – R&B, Rap/Hip-Hop, Soul-@Kingkanise

Keia – Hip-Hop, Rap-@iamakeia

Kids on Call Street – Pop Punk(remove, discontinued)

Killer Choice – Alternative Rock, Punk-@killer.choice

LA NENA – Pop, Reggaeton, Latin-@lanenamusica
(Remove,unsure of Instagram)

Learning to Swim – Indie Rock, Pop, Pop Punk, Punk(remove,discontinued)

Lex & Fly – R&B, Soul, Rock, Jazz- @lexandfly

Lillode – Techno, Femme PC @lillodeee

Loose Threads – Alt, Rock, Metal-@loosethreadzband

Loyal Customers – Alt, Experimental(remove, discontinued)

Marabella – Pop Punk, Other (Indie, Rock, Arctic Monkeys)(removed, discontinued)

McWire – Alt, Indie, nostalgic pop, ethereal- @mcwir_e (private Instagram)

Medians – Math Rock, Post-Rock- 
@mediansfl

Modayy – Hip-Hop, Rap-@gvo.mode

Morning Station – Folk Rock, Emo, Indie - @morningstationn

Mulch – Nu Metal,alt rock-@mulchbeat

Mutual Disdain – Indie Folk-@mutualdisdain

Mutual Friends – Alternative Rock, Pop Punk - @mutualfriends.music

Naomi Murray – Rap/Hip-Hop-@naomi_murray_


No Parts – Alt Rock/Pop | Indie | Queer Punk | Emo - @nopartsband 

Not Milk – Indie Rock, Alt - @notmilknotmilknotmilknotmilkn

Not Really – Alt, Rock, Indie/Surf Rock-not.reallymusic

NPC Luv – Indie Rock, Alt-Pop, Experimental - @npc.luv

Oak's Experiment – Indie, Rock, Alt, Ethereal - @oaks.experiment

On The Edge – Alt Rock, Indie Rock, Garage Rock - @on.the.edge.band

Our Final Feud – Metal, Hardcore, Metalcore - @ourfinalfeudofficial

Palace Rats – Rock, Metal, Classic Rock -@palaceratshq

Pale Hysteria – Screamo, Punk, Rock, Alternative - @palehysteria

Pineapple Tuesday – Indie Rock, Eclectic Rock - @pineappletuesdayofficial

Pit Violets – Rock, Garage Rock - @pitviolets

pondscum – Experimental, Alt, Metal, Rap,-@pondscumpondscumpondscumpondsc



Psychö Tropical – Punk Rock, Garage Rock - @psychotropicalsounds(remove)

Quintin Tyevon – Hip-Hop -@quintintyevon

Rasclat – Alt, Hip-Hop -@justrasclat

Red Letter Day – Alternative Rock, Indie Rock, Pop Punk, Punk-(remove)

Ry Guy – Electronic, Dance-@rplunt

S4GE – Alternative, Experimental, Indie-@sAge.mp3

SATIN – Heavy Metal-@satintheband

Sativa Redbull – Dance, EDM, Electronic - @sativaredbull

???Saturnalia???? – Indie Rock, Psychedelic Rock, Experimental - @saturnalia.fl

Sigs Inside – Rock, Garage Rock, Alt - @sigsinsideband_

Sleepybug – Indie Rock, Lo-fi, Bedroom Pop - @sleepybug.mp3

SLIT – Rap/Hip-Hop-@slitt__

Sofia Camille – Indie Pop, Alt-Soul - @sofiacamillemusic

Solomon Hill – Indie Rock, Alternative - @solomonhill.music

Soul Candy – Flower Pop, Pop, R&B, Soul-@soulcandyband_

steen – Alt, Hip-Hop, Rap- @steen.music

stoneheads – Nu Metal, Alt, Rock, Metal, Hip-Hop, Rap- @_stoneheads_

T-Shnegg – Electronic, Trap, Lo-fi,Chicago House, @dj_tschnegg

Taint – Metal, Deathcore, Hardcore Punk-@fattaint

The Casualties – Pop, Alt, Rock, Queer Rock, Folk-@thecasualties

The Flirt – Pop Rock, Heavy metal, Emo - @wearetheflirt

The Nancys – Indie, Folk, Alt - @thenancysband

The NOVA – Pop, Alt, Rock-@thenovatheband

The Relish Girls – Soft Rock, Indie Pop - @therelishgirls

The Retrograde – Blues, Rock n Roll, Rock @theretrogradeofficial

The Village Idiots – Indie Rock, Alternative Rock-@thevillageidiotsband

The Yeah Babys – Indie Rock, Soul, Alt Pop - @theyeahbabys

DJ Tim Greene – Electronic, Dance, Riddim, Futurebass-deejay_timothy_greene

Unwanted Company – Emo(remove)

Westgreen – Alt Rock, Indie - @westgreenfl

William Creamer – Pop, Alt-@williamcreamer

WormWorld – Punk, Rock, -@wormworldband

Your Weatherboys – Indie Rock, Dance Rock, Alternative Pop - @weatherboystheband

yoyi – Pop, Alt(remove)

YungPhlan – Hip-Hop, Dance- @yungphlan

YVSN – Hip-Hop-@official.yvsn

z – Alt, Rock, Metal (remove)